######....................########################....#######
#..##...################..........#.......###......##..##...#
##....####..........##########.####.#####..#####.#####....###
##.#####...#######....................##..###....##..###.####
#..##....###...#################.###..#..###..####....##..###
#.#.##.###...#...###......###.....##.##.###..##....##..##..##
#.#.#..##..#####.....####.###.###..###......##########..##..#
#...#.##..##..##.#####.##.##...##..###.#######......###.###.#
##.##.###....###.###...##....#.##.###..##......####.....###.#
#..##..#######.....#.#..###.####..##..##..#########.#######.#
##.###..###....#####.##.######...###.###.##...###.....###...#
##...##.....#####....##........####....#..###..######....#.##
#..#..########....#######..##.######.#.##.####....#####.##.##
###..###.......#####......##.....#####.##..######.##..#....##
#...##...#######.....###############.#..##...#B##.##.###.####
#.#.##.###...#######.......##....###.##..#.###..#.##.#####.##
#.#.##..##.#.....#########...##......#..#..##..##.#....#....#
#...###.###.A##..........####...#.##.##.#.##...##.####...#.##
##.####.....############......#####..##.#....###.......###..#
##..##########........##########....##..######...#########.##
###............#####.............##.###........###.###.....##
##################################################.....######
